"|","|","|","|","|","|","|","|","|","|","|","|","|","|","|","|","|","|","|","|","|","|","|","|","|","|","|","|","|","|","|","|","|","|","|","|","|","|","|","|","|","|","|","|","|"
"|","|","|","|","|","|","|","|","|","|","|","|","|","|","|","|","|","|",".","|","|","|","|","|","|","|","|","|","|","|","|","|","|","|","|","|","|","|","|","|","|","|",".","|","|"
"|","|","|","|","|","|","|","|","|","|","|","|","|","|","|","|","|","|",".",".","|","|","|","|","|","|","|","|","|","|","|","|","|","|","|","|","|","|","|","|",".",".",".","|","|"
"|","|","|","|","|","|","|","|","|","|","|","|","|","|","|","|","|","|",".",".",".","|","|","|","|","|","|","|","|","|","|","|","|","|","|","|","|","|","|"," ",".",".","|","|","|"
"|","|","|","|","|","|","|","|","|","|","|","|","|","|","|","|","|","|","|","."," "," ","|","|","|","|","|","|","|","|","|","|","|","|","|","|","|","|"," "," ",".","|","|","|","|"
"|","|","|","|","|","|","|","|","|","|","|","|","|","|","|","|","|","|","|"," "," "," "," ","|","|","|","|","|","|","|","|","|","|","|","|","|","|"," "," "," "," ","|","|","|","|"
"|","|","|","|","|","|","|","|","|","|","|","|","|","|","|","|","|","|","|"," "," "," "," ","|","|","|","|","|","|","|","|","|","|","|","|","|","|"," "," "," "," ","|","|","|","|"
"|","|","|","|","|","|","|","|","|","|","|","|","|","|","|","|","|","|","|"," "," "," "," "," ","|","|","|","|","|","|","|","|","|","|","|","|"," "," "," "," "," ","|","|","|","|"
"|","|","|","|","|","|","|","|","|","|","|","|","|","|","|","|","|","|","|","|"," "," "," "," ","|","|","|","|","|","|","|","|","|","|","|","|"," "," "," "," ","|","|","|","|","|"
"|","|","|","|","|"," "," ","|","|","|","|","|","|","|","|","|","|","|","|","|"," "," "," "," ","|","|"," "," "," "," "," "," ","|","|","|"," "," "," "," ","|","|","|","|","|","|"
"|","|","|","|"," "," "," "," ","|","|","|","|","|","|","|","|","|","|","|","|","|"," ","."," "," "," "," "," "," "," "," "," "," "," "," "," "," "," ","|","|","|","|","|","|","|"
"|","|","|","|"," "," "," "," "," ","|","|","|","|","|","|","|","|","|","|","|","|","|"," "," "," "," "," "," "," "," "," "," "," "," "," "," "," ","|","|","|","|","|","|","|","|"
"|","|","|"," "," "," "," "," "," "," ","|","|","|","|","|","|","|","|","|","|","|"," ","."," "," "," "," "," "," "," "," ",".","."," "," "," ","|","|","|","|","|","|","|","|","|"
"|","|"," "," "," "," "," "," "," "," "," ","|","|","|","|","|","|","|","|","|","|",".",".","."," "," "," "," "," "," ",".",".",".","."," "," "," ","|","|","|","|","|","|","|","|"
"|","|"," "," "," "," "," "," "," "," "," "," ","|","|","|","|","|","|","|","|"," ",".",".","."," "," "," "," "," "," ",".",".",".","."," "," "," ","|","|","|","|","|","|","|","|"
"|"," "," "," "," "," "," "," "," "," "," "," "," ","|","|","|","|","|","|","|"," "," ","."," "," ","."," "," "," "," "," ",".","."," "," "," "," "," ","|","|","|","|","|","|","|"
"|"," "," "," "," "," "," "," "," "," "," "," "," ","|","|","|","|","|","|","|","."," "," "," "," "," "," "," "," "," "," "," "," "," ",".","."," "," ","|","|","|","|","|","|","|"
"|"," "," "," "," "," "," "," "," "," "," "," "," "," ","|","|","|","|","|","|","."," "," "," ",".",".",".",".","."," "," "," "," ",".",".",".","."," ","|","|","|","|","|","|","|"
"|","|","|"," "," "," "," "," "," "," "," "," "," "," "," ","|","|","|","|","|","."," "," "," "," ",".",".","."," "," "," "," "," ",".",".",".","."," ","|","|","|","|","|","|","|"
"|","|","|","|","|"," "," "," "," "," "," "," "," "," "," "," ","|","|","|","|","|"," "," "," "," ",".",".","."," "," "," "," "," ",".",".",".","."," ","|","|","|","|","|","|","|"
"|","|","|","|","|","|","|"," "," "," "," "," "," "," "," "," ","|","|","|","|","|"," "," "," "," "," ","."," "," "," "," "," "," "," ",".","."," "," ","|","|","|","|","|","|","|"
"|","|","|","|","|","|","|","|","|"," "," "," "," "," "," ","|","|","|","|","|","|","|"," "," "," "," "," "," "," "," "," "," "," "," "," "," "," "," "," ","|","|","|","|","|","|"
"|","|","|","|","|","|","|","|","|","|","|"," "," "," ","|","|","|","|","|","|","|","|"," "," "," "," "," "," "," "," "," "," "," "," "," "," "," "," "," ","|","|","|","|","|","|"
"|","|","|","|","|","|","|","|","|","|","|","|"," "," ","|","|","|","|","|","|","|","|"," "," "," "," "," "," "," "," "," "," "," "," "," "," "," "," "," ","|","|","|","|","|","|"
"|","|","|","|","|","|","|","|","|","|","|"," "," ","|","|","|","|","|","|","|","|"," "," "," "," "," "," "," "," "," "," "," "," "," "," "," "," "," "," ","|","|","|","|","|","|"
"|","|","|","|","|","|","|","|","|","|","|"," "," "," ","|","|","|","|","|","|","|"," "," "," "," "," "," "," "," "," "," "," "," "," "," "," "," "," "," ","|","|","|","|","|","|"
"|","|","|","|","|","|","|","|","|","|"," "," "," "," "," ","|","|","|","|","|","|"," "," "," "," "," "," "," "," "," "," "," "," "," ","|"," "," "," "," ","|","|","|","|","|","|"
"|","|","|","|","|","|","|","|","|","|","|"," "," "," "," "," ","|","|","|","|"," "," "," "," "," "," "," "," ","|"," "," "," "," ","|"," "," "," "," "," ","|","|","|","|","|","|"
"|","|","|","|","|","|","|","|","|","|","|","|","|"," "," "," ","|","|","|","|"," "," "," "," "," "," "," "," "," ","|"," "," ","|"," "," "," "," "," ","|","|","|","|","|","|","|"
"|","|","|","|","|","|","|","|","|","|","|","|","|","|"," ","|","|","|","|"," "," "," "," ","|"," "," "," "," "," "," ","|"," ","|","|"," "," "," ","|"," ","|","|","|","|","|","|"
"|","|","|","|","|","|","|","|","|","|","|","|","|","|"," ","|","|","|"," "," "," "," "," "," ","|","|"," "," "," ","|"," "," "," ","|"," ","|","|"," "," "," ","|","|","|","|","|"
"|","|","|","|","|","|","|","|","|","|","|","|","|"," "," "," ","|","|"," "," "," "," "," "," "," "," ","|","|","|"," "," "," "," ","|","|"," "," "," "," "," ","|","|","|","|","|"
"|","|","|","|","|","|","|","|","|","|","|","|","|"," "," "," "," ","."," "," "," "," "," "," "," "," "," "," "," "," "," "," "," "," "," "," "," "," "," "," ","|","|","|","|","|"
"|","|","|","|","|","|","|","|","|","|","|","|","|","|","|"," "," "," "," "," "," "," "," "," "," "," "," "," "," "," "," "," "," "," "," "," "," "," "," "," ","|","|","|","|","|"
"|","|","|","|","|","|","|","|","|","|","|","|","|","|","|","|","."," "," "," "," "," "," "," "," "," "," "," "," "," "," "," "," "," "," "," "," "," "," ","|","|","|","|","|","|"
"|","|","|","|","|","|","|","|","|","|","|","|","|","|","|","|","|"," "," "," "," "," "," "," "," "," "," "," "," "," "," "," "," "," "," "," "," "," "," ","|","|","|","|","|","|"
"|","|","|","|","|","|","|","|","|","|","|","|","|","|","|","|","|","|"," "," "," "," "," "," "," "," "," "," "," "," "," "," "," "," "," "," "," "," ","|","|","|","|","|","|","|"
"|","|","|","|","|","|","|","|","|","|","|","|","|","|","|","|","|","|"," "," "," "," "," "," "," "," "," "," "," "," "," "," "," "," "," "," "," ","|","|","|","|","|","|","|","|"
"|","|","|","|","|","|","|","|","|","|","|","|","|","|","|","|","|","|","|"," "," "," "," "," "," ","|","|","|","|","|",".",".","."," "," ","|","|","|","|","|","|","|","|","|","|"
"|","|","|","|","|","|","|","|","|","|","|","|","|","|","|","|","|","|","|","|","."," "," ",".",".","|","|","|","|","|","|","|"," "," "," "," "," "," ","|","|","|","|","|","|","|"
"|","|","|","|","|","|","|","|","|","|","|","|","|","|","|","|","|","|","|"," "," "," "," "," ","|","|","|","|","|","|","|","|","|","|","|"," "," "," "," ","|","|","|","|","|","|"
"|","|","|","|","|","|","|","|","|","|","|","|","|","|","|","|","|","|"," "," "," "," ","|","|","|","|","|","|","|","|","|","|","|","|","|","|","|","|","|","|","|","|","|","|","|"
"|","|","|","|","|","|","|","|","|","|","|","|","|","|","|","|","|","|"," "," "," ","|","|","|","|","|","|","|","|","|","|","|","|","|","|","|","|","|","|","|","|","|","|","|","|"
"|","|","|","|","|","|","|","|","|","|","|","|","|","|","|","|","|","|","|","|","|","|","|","|","|","|","|","|","|","|","|","|","|","|","|","|","|","|","|","|","|","|","|","|","|"
