"|","|","|","|","|","|","|","|","|","|","|","|","|","|","|","|","|","|","|","|","|","|","|","|","|","|","|","|","|"
"|","|","|","|","|","|","|","|","|","|","|","|"," "," "," "," "," ","|","|","|","|","|","|","|","|","|","|","|","|"
"|","|","|","|","|","|","|","|","|","|","|","|"," "," "," "," "," ","|","|","|","|","|","|","|","|","|","|","|","|"
"|","|","|","|","|","|","|"," "," "," "," "," "," "," "," "," "," "," "," "," "," "," ","|","|","|","|","|","|","|"
"|","|","|","|","|","|","|"," ","|","|","|","|"," "," "," "," "," ","|","|","|","|"," ","|","|","|","|","|","|","|"
"|","|","|","|","|"," "," "," "," "," ","|","|"," "," "," "," "," ","|","|"," "," "," "," "," ","|","|","|","|","|"
"|","|","|","|","|"," "," "," "," "," ","|","|","|","|","|","|","|","|","|"," "," "," "," "," ","|","|","|","|","|"
"|","|","|"," "," "," "," "," "," "," "," "," ","|","|","|","|","|"," "," "," "," "," "," "," "," "," ","|","|","|"
"|","|","|"," ","|"," "," "," "," "," ","|"," ","|","|","|","|","|"," ","|"," "," "," "," "," ","|"," ","|","|","|"
"|","|","|"," ","|","|","|","|","|","|","|"," ","|","|","|","|","|"," ","|","|","|","|","|","|","|"," ","|","|","|"
"|"," "," "," "," "," ","|","|","|"," "," "," "," "," ","|"," "," "," "," "," ","|","|","|"," "," "," "," "," ","|"
"|"," "," "," "," "," ","|","|","|"," "," "," "," "," ","|"," "," "," "," "," ","|","|","|"," "," "," "," "," ","|"
"|"," "," "," "," "," ","|","|","|"," "," "," "," "," ","|"," "," "," "," "," ","|","|","|"," "," "," "," "," ","|"
"|"," "," "," "," "," ","|","|","|"," "," "," "," "," ","|"," "," "," "," "," ","|","|","|"," "," "," "," "," ","|"
"|","|","|","|","|","|","|","|","|","|","|","|","|","|","|","|","|","|","|","|","|","|","|","|","|","|","|","|","|"
