|,|,|,|,|,|,|,|,|,|,|,|,|,|,|,|,|,|,|,|,|,|,|,|,|,|,|,|,|,|,|,|,|,|,|,|,|,|,|,|,|,|,|,|,|
|,|,|,|,|,|,|,|,|,|,|,|,|,|,|,|,|,|,.,|,|,|,|,|,|,|,|,|,|,|,|,|,|,|,|,|,|,|,|,|,|,|,.,|,|
|,|,|,|,|,|,|,|,|,|,|,|,|,|,|,|,|,|,.,.,|,|,|,|,|,|,|,|,|,|,|,|,|,|,|,|,|,|,|,|,.,.,.,|,|
|,|,|,|,|,|,|,|,|,|,|,|,|,|,|,|,|,|,.,.,.,|,|,|,|,|,|,|,|,|,|,|,|,|,|,|,|,|,|, ,.,.,|,|,|
|,|,|,|,|,|,|,|,|,|,|,|,|,|,|,|,|,|,|,., , ,|,|,|,|,|,|,|,|,|,|,|,|,|,|,|,|, , ,.,|,|,|,|
|,|,|,|,|,|,|,|,|,|,|,|,|,|,|,|,|,|,|, , , , ,|,|,|,|,|,|,|,|,|,|,|,|,|,|, , , , ,|,|,|,|
|,|,|,|,|,|,|,|,|,|,|,|,|,|,|,|,|,|,|, , , , ,|,|,|,|,|,|,|,|,|,|,|,|,|,|, , , , ,|,|,|,|
|,|,|,|,|,|,|,|,|,|,|,|,|,|,|,|,|,|,|, , , , , ,|,|,|,|,|,|,|,|,|,|,|,|, , , , , ,|,|,|,|
|,|,|,|,|,|,|,|,|,|,|,|,|,|,|,|,|,|,|,|, , , , ,|,|,|,|,|,|,|,|,|,|,|,|, , , , ,|,|,|,|,|
|,|,|,|,|, , ,|,|,|,|,|,|,|,|,|,|,|,|,|, , , , ,|,|, , , , , , ,|,|,|, , , , ,|,|,|,|,|,|
|,|,|,|, , , , ,|,|,|,|,|,|,|,|,|,|,|,|,|, ,., , , , , , , , , , , , , , , ,|,|,|,|,|,|,|
|,|,|,|, , , , , ,|,|,|,|,|,|,|,|,|,|,|,|,|, , , , , , , , , , , , , , , ,|,|,|,|,|,|,|,|
|,|,|, , , , , , , ,|,|,|,|,|,|,|,|,|,|,|, ,., , , , , , , , ,.,., , , ,|,|,|,|,|,|,|,|,|
|,|, , , , , , , , , ,|,|,|,|,|,|,|,|,|,|,.,.,., , , , , , ,.,.,.,., , , ,|,|,|,|,|,|,|,|
|,|, , , , , , , , , , ,|,|,|,|,|,|,|,|, ,.,.,., , , , , , ,.,.,.,., , , ,|,|,|,|,|,|,|,|
|, , , , , , , , , , , , ,|,|,|,|,|,|,|, , ,., , ,., , , , , ,.,., , , , , ,|,|,|,|,|,|,|
|, , , , , , , , , , , , ,|,|,|,|,|,|,|,., , , , , , , , , , , , , ,.,., , ,|,|,|,|,|,|,|
|, , , , , , , , , , , , , ,|,|,|,|,|,|,., , , ,.,.,.,.,., , , , ,.,.,.,., ,|,|,|,|,|,|,|
|,|,|, , , , , , , , , , , , ,|,|,|,|,|,., , , , ,.,.,., , , , , ,.,.,.,., ,|,|,|,|,|,|,|
|,|,|,|,|, , , , , , , , , , , ,|,|,|,|,|, , , , ,.,.,., , , , , ,.,.,.,., ,|,|,|,|,|,|,|
|,|,|,|,|,|,|, , , , , , , , , ,|,|,|,|,|, , , , , ,., , , , , , , ,.,., , ,|,|,|,|,|,|,|
|,|,|,|,|,|,|,|,|, , , , , , ,|,|,|,|,|,|,|, , , , , , , , , , , , , , , , , ,|,|,|,|,|,|
|,|,|,|,|,|,|,|,|,|,|, , , ,|,|,|,|,|,|,|,|, , , , , , , , , , , , , , , , , ,|,|,|,|,|,|
|,|,|,|,|,|,|,|,|,|,|,|, , ,|,|,|,|,|,|,|,|, , , , , , , , , , , , , , , , , ,|,|,|,|,|,|
|,|,|,|,|,|,|,|,|,|,|, , ,|,|,|,|,|,|,|,|, , , , , , , , , , , , , , , , , , ,|,|,|,|,|,|
|,|,|,|,|,|,|,|,|,|,|, , , ,|,|,|,|,|,|,|, , , , , , , , , , , , , , , , , , ,|,|,|,|,|,|
|,|,|,|,|,|,|,|,|,|, , , , , ,|,|,|,|,|,|, , , , , , , , , , , , , ,|, , , , ,|,|,|,|,|,|
|,|,|,|,|,|,|,|,|,|,|, , , , , ,|,|,|,|, , , , , , , , ,|, , , , ,|, , , , , ,|,|,|,|,|,|
|,|,|,|,|,|,|,|,|,|,|,|,|, , , ,|,|,|,|, , , , , , , , , ,|, , ,|, , , , , ,|,|,|,|,|,|,|
|,|,|,|,|,|,|,|,|,|,|,|,|,|, ,|,|,|,|, , , , ,|, , , , , , ,|, ,|,|, , , ,|, ,|,|,|,|,|,|
|,|,|,|,|,|,|,|,|,|,|,|,|,|, ,|,|,|, , , , , , ,|,|, , , ,|, , , ,|, ,|,|, , , ,|,|,|,|,|
|,|,|,|,|,|,|,|,|,|,|,|,|, , , ,|,|, , , , , , , , ,|,|,|, , , , ,|,|, , , , , ,|,|,|,|,|
|,|,|,|,|,|,|,|,|,|,|,|,|, , , , ,., , , , , , , , , , , , , , , , , , , , , , ,|,|,|,|,|
|,|,|,|,|,|,|,|,|,|,|,|,|,|,|, , , , , , , , , , , , , , , , , , , , , , , , , ,|,|,|,|,|
|,|,|,|,|,|,|,|,|,|,|,|,|,|,|,|,., , , , , , , , , , , , , , , , , , , , , , ,|,|,|,|,|,|
|,|,|,|,|,|,|,|,|,|,|,|,|,|,|,|,|, , , , , , , , , , , , , , , , , , , , , , ,|,|,|,|,|,|
|,|,|,|,|,|,|,|,|,|,|,|,|,|,|,|,|,|, , , , , , , , , , , , , , , , , , , , ,|,|,|,|,|,|,|
|,|,|,|,|,|,|,|,|,|,|,|,|,|,|,|,|,|, , , , , , , , , , , , , , , , , , , ,|,|,|,|,|,|,|,|
|,|,|,|,|,|,|,|,|,|,|,|,|,|,|,|,|,|,|, , , , , , ,|,|,|,|,|,.,.,., , ,|,|,|,|,|,|,|,|,|,|
|,|,|,|,|,|,|,|,|,|,|,|,|,|,|,|,|,|,|,|,., , ,.,.,|,|,|,|,|,|,|, , , , , , ,|,|,|,|,|,|,|
|,|,|,|,|,|,|,|,|,|,|,|,|,|,|,|,|,|,|, , , , , ,|,|,|,|,|,|,|,|,|,|,|, , , , ,|,|,|,|,|,|
|,|,|,|,|,|,|,|,|,|,|,|,|,|,|,|,|,|, , , , ,|,|,|,|,|,|,|,|,|,|,|,|,|,|,|,|,|,|,|,|,|,|,|
|,|,|,|,|,|,|,|,|,|,|,|,|,|,|,|,|,|, , , ,|,|,|,|,|,|,|,|,|,|,|,|,|,|,|,|,|,|,|,|,|,|,|,|
|,|,|,|,|,|,|,|,|,|,|,|,|,|,|,|,|,|,|,|,|,|,|,|,|,|,|,|,|,|,|,|,|,|,|,|,|,|,|,|,|,|,|,|,|
